Fame.	['comedies\n']
considered,	['comedies\n', 'comedies\n']
Fame,	['tragedies\n', 'tragedies\n']
considered.	['comedies\n', 'histories\n']
HURTLE	['glossary\n']
mustachio	['histories\n']
Debts	['tragedies\n']
ocean:	['tragedies\n']
untold,	['poems\n']
protested,	['comedies\n']
ocean;	['comedies\n']
sending.	['tragedies\n', 'histories\n']
trimmings;	['glossary\n']
considered:	['tragedies\n']
offendeth	['tragedies\n']
instant;	['tragedies\n']
beadsmen	['histories\n']
gad	['tragedies\n']
whither,	['tragedies\n', 'histories\n', 'comedies\n', 'comedies\n']
(STAFFORD:)	['histories\n']
chatter	['comedies\n', 'tragedies\n']
scold	['histories\n', 'comedies\n', 'comedies\n', 'comedies\n', 'glossary\n']
trumpets;	['histories\n', 'histories\n']
Sergeant.	['histories\n']
list	['tragedies\n', 'tragedies\n', 'tragedies\n', 'tragedies\n', 'tragedies\n', 'tragedies\n', 'tragedies\n', 'tragedies\n', 'tragedies\n', 'histories\n', 'histories\n', 'histories\n', 'histories\n', 'histories\n', 'histories\n', 'hi
stories\n', 'histories\n', 'poems\n', 'poems\n', 'glossary\n', 'comedies\n', 'comedies\n', 'comedies\n', 'comedies\n', 'comedies\n', 'comedies\n', 'comedies\n', 'comedies\n', 'comedies\n']
Sergeant,	['histories\n', 'tragedies\n']
Vulcan	['comedies\n', 'comedies\n', 'tragedies\n']
mutinies	['histories\n', 'tragedies\n']
instant?	['comedies\n', 'comedies\n']
whither?	['tragedies\n', 'comedies\n', 'comedies\n']
out-night	['comedies\n']
wax,	['tragedies\n', 'tragedies\n', 'tragedies\n', 'comedies\n', 'comedies\n', 'histories\n', 'histories\n', 'histories\n', 'poems\n']
unmindful	['histories\n']
Retreat	['histories\n', 'histories\n']
sea-sorrow.	['comedies\n']
creeps.	['poems\n']
Sergeant]	['histories\n', 'tragedies\n']
suck'd:	['tragedies\n']
Love-thoughts	['comedies\n']
spider.	['comedies\n']
franklin's	['tragedies\n']
Famed	['tragedies\n']
chameleon,	['histories\n']
Remorse?	['histories\n']
suck'd.	['poems\n']
slandered,	['comedies\n', 'comedies\n']
appropriation	['comedies\n']
wood:	['comedies\n', 'tragedies\n', 'tragedies\n', 'histories\n']
wood;	['histories\n', 'comedies\n', 'comedies\n', 'comedies\n', 'comedies\n']
